###########
#@55555555#
#555555555#
#555555555#
###########