###########
#99999999@#
#555......#
#777......#
###########