###########
#........@#
#8888.....#
#9999.....#
###########