#############
#1111111111@#
#11111111111#
#22222222222#
#############