###########
#@77777777#
#777777777#
#777777777#
###########