###########
##9..9555@#
#5.5...33##
#7.7..999##
###########